04,01,10,10,0,0,0,0,0,0,0,0,0,0,0
0,0,0,0,0,0,0,0,0,0,0,0,0,0,0
0,0,0,0,0,0,0,0,0,0,0,0,0,0,0
0,0,0,0,0,0,13,0,0,0,0,0,0,0,0
0,0,0,0,20,0,0,0,0,13,0,0,0,21,0
0,0,0,0,17,1,1,1,1,1,1,1,1,1,1
11,10,10,10,10,10,10,10,10,10,10,10,10,10,12